1111111111111
10010000000C1
10E0011111001
1P00111000001
111111111111E
