11111111
10CP1111
1E111111
11111111
