11111111
10CP1111
1E111111
111111111
