1111111111111
1C01000000111
1000C10001111
1P001101000E1
1111111111111
